1111111111111111
1111111111111111
111111....111111
110..........011
000..........000
.......00.......
................
................
................
................
................
................
................
................
................
................